-,.,-,.,-,.,-
.,s,.,n,.,x,.
-,.,-,.,-,.,-
.,x,.,n,.,n,.
-,.,-,.,-,.,-
.,x,.,x,.,G,.
-,.,-,.,-,.,-