-,.,-,.,-,.,-,.,-,.,-
.,x,.,x,.,G,.,x,.,G,.
-,.,-,.,-,.,-,.,-,.,-
.,g,.,g,W,s,W,S,W,G,.
-,.,-,.,-,.,-,.,-,.,-
.,x,.,x,.,x,.,n,.,x,.
-,.,-,.,-,.,-,.,-,.,-
.,x,.,x,.,x,.,G,.,x,.
-,.,-,.,-,.,-,W,-,.,-