-,.,-,.,-,.,-,.,-,.,-
.,x,.,G,.,x,.,x,.,x,.
-,.,-,.,-,.,-,.,-,.,-
.,G,W,n,W,g,.,x,.,x,.
-,.,-,.,-,.,-,.,-,.,-
.,x,.,s,.,n,.,n,.,G,W
-,.,-,.,-,.,-,.,-,.,-
.,x,.,S,.,x,.,x,.,x,.
-,.,-,.,-,.,-,.,-,.,-