-,.,-,.,-,.,-,.,-
.,S,.,x,.,x,.,x,.
-,.,-,.,-,.,-,.,-
.,n,.,x,.,x,.,x,.
-,.,-,.,-,.,-,.,-
.,G,.,x,.,G,.,x,.
-,.,-,.,-,.,-,.,-
W,n,.,n,.,S,.,G,W
-,.,-,.,-,.,-,.,-
.,x,.,x,.,g,.,x,.
-,.,-,.,-,.,-,.,-