-,.,-,.,-,.,-,.,-
.,x,.,G,.,G,.,x,.
-,.,-,W,-,.,-,.,-
.,G,.,g,.,g,.,G,.
-,.,-,.,-,.,-,.,-
.,x,.,G,.,g,.,g,.
-,.,-,.,-,.,-,.,-
.,x,.,x,.,x,.,g,.
-,.,-,.,-,.,-,.,-