-,W,-,.,-,.,-,.,-,.,-
.,G,.,x,.,x,.,x,.,x,.
-,.,-,.,-,.,-,.,-,.,-
.,n,.,x,.,x,.,x,.,x,.
-,.,-,.,-,.,-,.,-,.,-
.,n,.,x,.,x,.,S,.,x,.
-,.,-,.,-,.,-,.,-,.,-
W,n,.,n,.,n,.,G,.,x,.
-,.,-,.,-,.,-,.,-,.,-
.,x,.,x,.,x,.,g,W,G,.
-,.,-,.,-,.,-,.,-,.,-
.,x,.,x,.,x,.,g,.,x,.
-,.,-,.,-,.,-,.,-,.,-