-,W,-,.,-,.,-,.,-
.,G,.,x,.,x,.,x,.
-,.,-,.,-,.,-,.,-
.,n,.,x,.,G,.,x,.
-,.,-,.,-,.,-,.,-
.,n,.,G,W,n,W,n,.
-,.,-,.,-,.,-,.,-
W,n,.,n,.,s,.,S,.
-,.,-,.,-,.,-,.,-
.,x,.,x,.,x,.,g,.
-,.,-,.,-,.,-,.,-