-,.,-,.,-,.,-
.,s,.,n,.,x,.
-,.,-,.,-,.,-
.,x,.,G,.,x,.
-,.,-,.,-,.,-
.,G,.,s,.,G,.
-,.,-,.,-,.,-
.,x,.,s,.,x,.
-,.,-,.,-,.,-