-,W,-,.,-,.,-,.,-,.,-,.,-
.,n,.,x,.,x,.,x,.,x,.,x,.
-,.,-,.,-,.,-,.,-,.,-,.,-
W,n,.,n,.,n,.,b,.,x,.,x,.
-,.,-,.,-,.,-,.,-,.,-,.,-
.,G,.,x,.,x,.,b,W,n,.,n,.
-,.,-,.,-,.,-,.,-,.,-,.,-
.,x,.,x,.,x,.,n,.,n,.,n,.
-,.,-,.,-,.,-,.,-,.,-,.,-
.,x,.,x,.,x,.,n,.,G,.,n,.
-,.,-,.,-,.,-,.,-,.,-,.,-