-,.,-,.,-,.,-,.,-,.,-
.,G,.,n,.,s,.,x,.,x,.
-,.,-,.,-,.,-,.,-,.,-
.,x,.,G,.,x,.,x,.,S,.
-,.,-,.,-,.,-,.,-,.,-
.,x,.,n,.,x,.,x,.,b,.
-,.,-,.,-,.,-,.,-,.,-
.,G,W,n,.,n,.,n,.,n,.
-,.,-,.,-,.,-,.,-,.,-
.,x,.,x,.,g,.,x,.,n,.
-,.,-,.,-,.,-,.,-,.,-
.,x,.,x,.,x,.,x,.,n,.
-,.,-,.,-,.,-,.,-,.,-
.,x,.,x,.,x,.,x,.,G,.
-,.,-,.,-,.,-,.,-,.,-