-,W,-,.,-,.,-
.,n,.,n,.,n,W
-,.,-,.,-,.,-
.,n,.,x,.,n,.
-,.,-,.,-,.,-
.,S,.,x,.,n,.
-,.,-,.,-,.,-
W,G,.,n,.,n,.
-,.,-,.,-,W,-