-,.,-,.,-,.,-,.,-,.,-
.,G,.,x,.,x,.,B,.,x,.
-,.,-,.,-,.,-,.,-,.,-
.,x,.,x,.,x,.,x,.,x,.
-,.,-,.,-,.,-,.,-,.,-
.,n,.,x,.,n,.,n,.,n,.
-,.,-,.,-,.,-,.,-,.,-
.,x,.,x,.,x,.,x,.,x,.
-,.,-,.,-,.,-,.,-,.,-
.,x,.,x,.,x,.,G,.,B,.
-,.,-,.,-,.,-,.,-,.,-