-,.,-,.,-,.,-,.,-,.,-
.,x,.,x,.,n,.,x,.,x,.
-,.,-,.,-,.,-,.,-,.,-
.,x,.,x,.,n,.,x,.,G,.
-,.,-,.,-,.,-,.,-,.,-
.,G,.,G,.,b,.,x,.,n,.
-,.,-,.,-,.,-,.,-,.,-
.,x,.,x,.,x,.,x,.,n,.
-,.,-,.,-,.,-,.,-,.,-
.,x,.,S,.,B,.,G,.,B,.
-,.,-,.,-,.,-,.,-,.,-