-,W,-,.,-,.,-,.,-
.,G,.,x,.,x,.,x,.
-,.,-,.,-,.,-,.,-
.,n,.,x,.,x,.,x,.
-,.,-,.,-,.,-,.,-
.,S,.,G,.,n,.,S,.
-,.,-,.,-,.,-,.,-
.,x,.,x,.,x,.,G,.
-,.,-,.,-,.,-,.,-
.,x,.,x,.,x,.,n,.
-,.,-,.,-,.,-,.,-
.,x,.,x,.,x,.,S,.
-,.,-,.,-,.,-,.,-