-,.,-,.,-,.,-,.,-
W,S,.,n,.,n,.,S,.
-,.,-,.,-,.,-,.,-
.,n,.,G,W,G,.,n,.
-,.,-,.,-,.,-,.,-
.,n,.,G,W,G,.,n,.
-,.,-,.,-,.,-,.,-
.,S,.,n,.,n,.,S,W
-,.,-,.,-,.,-,.,-