-,.,-,.,-,.,-,.,-
.,n,.,x,.,x,.,F,.
-,.,-,.,-,.,-,.,-
.,x,.,x,.,x,.,G,.
-,.,-,.,-,.,-,.,-
.,x,.,x,.,x,.,b,.
-,.,-,.,-,.,-,.,-
.,F,.,x,.,x,.,n,.
-,.,-,.,-,.,-,W,-
.,G,.,x,.,x,.,G,.
-,.,-,.,-,.,-,.,-