-,.,-,.,-,.,-,.,-
.,x,.,x,.,x,.,G,.
-,.,-,.,-,.,-,.,-
.,S,.,n,.,s,.,n,.
-,.,-,.,-,.,-,.,-
.,x,.,x,.,n,.,x,.
-,.,-,.,-,.,-,.,-
.,x,.,x,.,n,.,x,.
-,.,-,.,-,.,-,.,-
.,x,.,x,.,G,.,x,.
-,.,-,.,-,W,-,.,-