-,.,-,.,-,.,-,.,-
.,S,.,n,.,n,W,x,.
-,.,-,.,-,.,-,.,-
.,x,.,x,.,S,.,x,.
-,.,-,.,-,.,-,.,-
.,x,.,x,.,G,.,x,.
-,.,-,.,-,.,-,.,-
.,x,.,x,.,s,.,G,.
-,.,-,.,-,.,-,.,-
.,x,.,x,.,G,.,x,.
-,.,-,.,-,W,-,.,-