-,.,-,.,-,.,-,.,-,.,-
.,x,.,G,.,x,.,x,.,x,.
-,.,-,.,-,.,-,.,-,.,-
.,x,.,x,.,x,.,x,.,x,.
-,.,-,.,-,.,-,.,-,.,-
.,x,.,n,.,n,.,x,.,n,.
-,.,-,.,-,.,-,.,-,.,-
W,G,.,n,.,n,.,n,.,S,.
-,.,-,.,-,.,-,.,-,.,-
.,x,.,x,.,x,.,x,.,x,.
-,.,-,.,-,.,-,.,-,.,-
.,x,.,s,.,F,.,G,.,B,.
-,.,-,.,-,.,-,.,-,.,-
.,x,.,x,.,G,.,x,.,x,.
-,.,-,.,-,.,-,.,-,.,-