-,.,-,.,-,.,-,.,-,.,-,.,-
.,n,.,F,.,b,.,x,.,x,.,x,.
-,.,-,.,-,W,-,.,-,.,-,.,-
.,n,.,x,.,b,.,x,.,G,.,x,.
-,.,-,.,-,.,-,.,-,.,-,.,-
.,G,.,x,.,b,.,x,.,n,.,x,.
-,.,-,.,-,.,-,.,-,.,-,.,-
.,g,.,n,.,G,.,n,.,n,.,G,.
-,.,-,.,-,.,-,.,-,.,-,.,-
.,x,.,x,.,G,.,x,.,x,.,x,.
-,.,-,.,-,.,-,.,-,.,-,.,-