-,.,-,.,-,.,-,.,-,.,-,.,-,.,-
.,x,.,x,.,F,.,x,.,x,.,x,.,x,.
-,.,-,.,-,.,-,.,-,.,-,.,-,.,-
.,x,.,x,.,n,.,x,.,x,.,x,.,x,.
-,.,-,.,-,.,-,.,-,.,-,W,-,W,-
.,x,.,x,.,n,.,x,.,x,.,G,.,G,.
-,.,-,.,-,.,-,.,-,.,-,.,-,.,-
.,S,.,S,.,S,.,n,.,G,.,n,.,n,W
-,.,-,.,-,.,-,.,-,.,-,.,-,.,-
.,x,.,x,.,n,.,x,.,x,.,n,.,G,.
-,.,-,.,-,.,-,.,-,.,-,W,-,.,-