-,W,-,.,-,.,-,.,-,.,-,.,-
.,G,.,x,.,x,.,x,.,x,.,x,.
-,.,-,.,-,.,-,.,-,W,-,.,-
W,G,.,S,.,n,.,n,.,n,.,n,W
-,.,-,W,-,.,-,.,-,.,-,.,-
W,S,.,G,.,n,.,n,.,n,.,n,.
-,.,-,.,-,.,-,.,-,.,-,.,-
.,x,.,x,.,x,.,x,.,G,.,n,.
-,.,-,.,-,.,-,.,-,.,-,.,-
.,x,.,x,.,x,.,x,.,S,.,S,.
-,.,-,.,-,.,-,.,-,.,-,.,-