-,.,-,.,-,.,-,.,-
.,g,.,x,.,x,.,x,.
-,.,-,.,-,.,-,.,-
.,n,.,x,.,x,.,x,.
-,.,-,.,-,.,-,.,-
W,n,.,n,.,S,.,G,W
-,.,-,.,-,.,-,.,-
.,G,.,x,.,b,.,G,.
-,.,-,.,-,.,-,.,-
.,B,.,x,.,n,.,x,.
-,.,-,.,-,.,-,.,-
.,x,.,x,.,G,.,x,.
-,.,-,.,-,.,-,.,-