-,.,-,.,-,.,-,.,-,.,-
.,x,.,x,.,G,.,x,.,x,.
-,.,-,.,-,.,-,.,-,.,-
.,S,.,n,.,n,.,n,.,n,.
-,.,-,.,-,.,-,.,-,.,-
.,n,.,x,.,x,.,x,.,n,.
-,.,-,.,-,W,-,.,-,.,-
.,n,.,G,W,B,W,x,.,n,.
-,.,-,.,-,W,-,.,-,.,-
.,G,.,x,.,x,.,x,.,n,.
-,.,-,.,-,.,-,.,-,.,-
.,n,.,n,.,n,.,n,.,S,.
-,.,-,.,-,.,-,.,-,.,-
.,x,.,x,.,F,.,x,.,x,.
-,.,-,.,-,.,-,.,-,.,-