-,.,-,.,-,.,-,.,-,.,-
.,x,.,x,.,G,.,x,.,x,.
-,.,-,.,-,.,-,.,-,.,-
.,G,.,F,.,n,.,x,.,n,.
-,.,-,.,-,.,-,.,-,.,-
.,G,.,s,.,n,.,x,.,G,.
-,.,-,.,-,.,-,.,-,.,-
.,x,.,G,.,b,.,x,.,S,.
-,.,-,.,-,.,-,.,-,.,-
.,x,.,x,.,x,.,x,.,x,.
-,.,-,.,-,.,-,.,-,.,-
.,x,.,x,.,x,.,x,.,B,.
-,.,-,.,-,.,-,.,-,.,-