-,.,-,.,-,.,-,.,-
.,g,.,n,.,x,.,x,.
-,.,-,.,-,.,-,.,-
.,x,.,n,.,x,.,x,.
-,.,-,W,-,.,-,.,-
.,x,.,n,.,n,.,n,.
-,.,-,.,-,.,-,.,-
.,x,.,x,.,n,.,G,.
-,.,-,.,-,.,-,.,-