-,.,-,.,-,.,-,.,-,.,-
.,B,.,x,.,x,.,x,.,x,.
-,.,-,.,-,.,-,.,-,.,-
.,n,.,x,.,G,.,n,.,n,.
-,.,-,.,-,.,-,W,-,.,-
.,b,.,G,.,G,.,n,.,n,.
-,.,-,.,-,.,-,W,-,.,-
.,n,.,x,.,n,.,G,.,b,.
-,.,-,.,-,.,-,.,-,.,-
.,x,.,x,.,x,.,x,.,S,.
-,.,-,.,-,.,-,.,-,.,-