-,.,-,.,-,.,-,.,-,.,-,.,-
.,x,.,x,.,x,.,x,.,G,.,x,.
-,.,-,.,-,.,-,.,-,W,-,.,-
.,S,.,B,.,n,.,n,.,n,.,x,.
-,.,-,.,-,.,-,.,-,.,-,.,-
.,x,.,x,.,x,.,S,.,x,.,x,.
-,.,-,.,-,.,-,.,-,.,-,.,-
.,x,.,x,.,x,.,g,.,n,.,x,.
-,.,-,.,-,.,-,.,-,.,-,.,-
.,x,.,x,.,x,.,n,.,x,.,x,.
-,.,-,.,-,.,-,.,-,.,-,.,-
.,x,.,x,.,x,.,G,.,G,.,G,W
-,.,-,.,-,.,-,W,-,.,-,.,-