-,.,-,.,-,.,-,.,-,.,-,.,-
.,b,.,b,.,n,.,n,.,x,.,x,.
-,.,-,.,-,.,-,.,-,.,-,.,-
.,n,.,x,.,x,.,n,.,x,.,x,.
-,.,-,.,-,.,-,.,-,.,-,.,-
.,b,.,n,.,n,W,n,.,n,.,G,.
-,.,-,.,-,.,-,.,-,.,-,.,-
.,x,.,n,W,G,.,n,.,x,.,x,.
-,.,-,.,-,.,-,.,-,.,-,.,-
.,x,.,n,.,G,.,n,.,x,.,x,.
-,.,-,.,-,.,-,.,-,.,-,.,-