-,.,-,.,-,.,-,.,-,.,-,.,-
.,x,.,x,.,G,.,G,.,G,.,G,.
-,.,-,.,-,.,-,W,-,.,-,.,-
.,F,.,G,.,x,.,G,.,g,.,g,.
-,.,-,.,-,.,-,.,-,.,-,.,-
.,x,.,x,.,x,.,x,.,g,.,g,.
-,.,-,.,-,.,-,.,-,.,-,.,-
.,x,.,x,.,x,.,x,.,b,.,x,.
-,.,-,.,-,.,-,.,-,.,-,.,-