-,.,-,.,-,.,-,.,-
.,G,.,x,.,x,.,x,.
-,.,-,.,-,.,-,.,-
.,n,.,n,.,n,.,b,.
-,.,-,.,-,.,-,.,-
.,G,.,G,.,b,.,S,.
-,.,-,.,-,.,-,.,-
.,x,.,G,.,g,.,x,.
-,.,-,.,-,.,-,.,-