-,.,-,.,-,.,-,.,-,.,-,.,-
.,x,.,x,.,n,.,x,.,x,.,x,.
-,.,-,.,-,.,-,.,-,.,-,.,-
.,x,.,x,.,n,.,x,.,x,.,x,.
-,.,-,.,-,.,-,.,-,.,-,.,-
.,x,.,x,.,b,.,x,.,B,.,x,.
-,.,-,.,-,.,-,.,-,.,-,.,-
.,x,.,x,.,n,.,x,.,n,.,F,.
-,.,-,.,-,.,-,.,-,.,-,.,-
.,G,.,x,.,n,.,n,.,G,.,x,.
-,.,-,.,-,W,-,.,-,.,-,.,-
.,x,.,x,.,G,.,x,.,x,.,x,.
-,.,-,.,-,.,-,.,-,.,-,.,-