-,.,-,.,-,.,-,.,-
.,x,.,x,.,G,.,x,.
-,.,-,.,-,.,-,.,-
.,x,.,x,.,S,.,x,.
-,.,-,.,-,.,-,.,-
W,G,.,n,.,n,.,x,.
-,.,-,.,-,.,-,.,-
.,x,.,x,.,s,.,G,.
-,.,-,.,-,.,-,.,-
.,x,.,x,.,g,.,x,.
-,.,-,.,-,.,-,.,-