-,.,-,.,-,.,-,.,-,.,-,.,-
.,x,.,x,.,x,.,b,.,n,.,x,.
-,.,-,.,-,.,-,.,-,.,-,.,-
.,x,.,x,.,x,.,n,.,G,.,x,.
-,.,-,.,-,.,-,.,-,.,-,.,-
.,F,.,B,.,G,.,n,.,G,.,G,.
-,.,-,.,-,.,-,.,-,.,-,.,-
.,x,.,x,.,x,.,x,.,n,.,x,.
-,.,-,.,-,.,-,.,-,.,-,.,-
.,x,.,x,.,x,.,x,.,S,.,x,.
-,.,-,.,-,.,-,.,-,.,-,.,-