-,.,-,.,-,.,-,.,-
.,x,.,x,.,n,.,x,.
-,.,-,.,-,.,-,.,-
W,G,.,G,.,g,.,n,.
-,.,-,.,-,.,-,.,-
.,G,.,x,.,n,.,G,.
-,.,-,.,-,.,-,.,-
.,n,.,x,.,b,.,S,.
-,.,-,.,-,.,-,.,-
.,n,.,G,.,S,.,S,.
-,.,-,.,-,.,-,.,-