-,.,-,.,-,.,-,.,-
.,x,.,x,.,G,.,x,.
-,.,-,.,-,W,-,.,-
.,x,.,x,.,S,.,x,.
-,.,-,.,-,.,-,.,-
.,G,W,b,.,n,.,n,.
-,.,-,.,-,.,-,.,-
.,x,.,G,.,n,.,x,.
-,.,-,.,-,.,-,.,-
.,x,.,G,.,n,.,B,.
-,.,-,.,-,.,-,.,-
.,x,W,n,.,F,.,x,.
-,.,-,.,-,.,-,.,-