-,.,-,.,-,.,-,.,-,.,-
.,g,.,g,.,g,.,x,.,x,.
-,.,-,.,-,.,-,.,-,.,-
.,g,.,g,.,g,.,x,.,x,.
-,.,-,.,-,.,-,.,-,.,-
.,g,.,g,.,n,.,G,.,G,.
-,.,-,.,-,.,-,.,-,.,-
.,x,.,x,.,G,.,G,.,G,.
-,.,-,.,-,.,-,.,-,.,-
.,x,.,x,.,G,.,G,.,G,.
-,.,-,.,-,.,-,.,-,.,-