-,.,-,.,-,.,-,.,-,.,-
.,b,.,x,.,x,.,x,.,x,.
-,.,-,.,-,.,-,.,-,.,-
.,b,.,n,.,n,.,n,.,G,.
-,.,-,.,-,.,-,.,-,.,-
.,n,.,G,.,n,.,n,.,b,.
-,.,-,.,-,.,-,.,-,.,-
.,x,.,x,.,n,.,n,.,G,.
-,.,-,.,-,.,-,.,-,.,-
.,x,.,x,.,b,.,x,.,G,.
-,.,-,.,-,.,-,.,-,.,-