-,.,-,.,-,.,-,.,-,.,-
.,G,.,G,.,x,.,x,.,x,.
-,.,-,.,-,.,-,.,-,.,-
.,n,.,F,.,x,.,x,.,G,.
-,.,-,.,-,.,-,.,-,.,-
.,n,.,s,.,x,.,x,.,x,.
-,.,-,.,-,.,-,.,-,.,-
.,x,.,x,.,x,.,x,.,x,.
-,.,-,.,-,.,-,.,-,.,-
.,F,.,x,.,x,.,G,.,F,.
-,.,-,.,-,.,-,.,-,.,-