-,.,-,.,-,.,-,.,-,W,-
W,G,.,n,.,n,.,n,.,n,.
-,.,-,.,-,.,-,.,-,.,-
.,x,.,x,.,x,.,x,.,g,.
-,.,-,.,-,.,-,.,-,.,-
.,x,.,x,.,S,.,n,.,n,W
-,.,-,.,-,.,-,.,-,.,-
.,x,.,x,.,x,.,x,.,G,.
-,.,-,.,-,.,-,.,-,.,-